AAAAAAAAAAAAAAAAAAAAAAAAAAAAAAAA
A P X   X   D X   X   AAA X A
A   DDA  X  D   AAA X A A   A
A X D  X AAD D  X X DD A D XA
A   A      D DD   A  A A  X A
AAA D X AA D X  DDA  D AAA  A
A X   X D X   X A X X EFB XA
A   AAA D  AAAAAAA  DD B B  A
A X D X D  A X   X A D F B XA
A   A   D  A  DDD  A   EBF  A
AAD A X DA X  D D  A D   A XA
A X   X D  A XC D  A D X D  A
A   AAA D  AAAAAAA  DD A D XA
A X D   A  X   X  X X  DDD  A
A   D X DDDA X  AAA  AA X   A
AAA   X   X  DD   X  X  EF  A
A   DDDD  D X AAA  AA BC  X A
A X X   D X A   X D X EF D A
A   DDD A   AAA D  AA CBF  A
A X X   D X X  XX D X AA X A
A   AAA   D  DD A X X A A  A
A X X   DDA X  AA  DDA AAD A
AAA   X X   X   X  X   X X A
A   DDDDDDDDDDDDDDDDDDDD D A
A X X   X   X   X   X   X XA
AAAAAAAAAAAAAAAAAAAAAAAAAAAAA