AAAAAAAAAAAAAAAAAAAAAAA
A P X   D   X   X   X A
A   AA  A   D   AAA   A
A X D X     A   D X A A
A   A   DDD   AAD   X A
A X   X D X   D  X  A A
AAA D   D   X A   X D A
A X   X   DAD A D   A A
A   AAA X D X D   X D A
A X A   X D   A D A X A
A   D X AA  D AA  A   A
A X   X A   DA X  A X A
A   AA  D X   D   D   A
A X D   X   EBFB  A X A
AAA   X     DCD   AA  A
A   DDD   X AAA     X A
A X X   D X A   D X A A
AAAAAAAAAAAAAAAAAAAAAAA
