################
#AAAA      BBB #
#A  A      B  B#
#A  P         E#
#AAAA      BBB #
################
s
