################
#   A   B      #
#   P      E   #
#   C          #
################
