AAAADAABAAACAAAAAAAADADAA
A  P  A   A             B
D     A B A    A C A    D
C              A   A    D
AADDDDDAAADAADAAAAADADAAA
