################
#   ####       #
#   #  #   E   #
# P #  #       #
#   ####       #
#              #
################
